Enemy 1
||||||||||||||||||||
|B        V       B|
|                 H|
|H                 |
|                  |
|                  |
|P       V        B|
||||||||||||||||||||