Movement
||||||||||||||||
|V |H          | 
|  |          H|
|  |||||||||||||
|  |     |     | 
|  | S   |  C  |
|  |     |     |
|  |     |     |
|  |||||||||||||
|  |           |
|  |           |
| V|    P     B|
||||||||||||||||