Flying
||||||||||||||||||||
|                  |
|                  |
| B              B |
|-----        -----|
|                  |
|                  |
|                  |
|                  |
| B              B |
|-----        -----|
|                  |
|                  |
|                  |
|        P         |
||||||||||||||||||||