Playhouse
|||||||||||||||||||||||||
|     H       B        B|
|           -----    ---|
|  B          V         |
|-----            B     |
|               -----   |
|   H    B           B  |
|      -----       -----|
|              B        |
|  B         -----V     |
|-----                  |
|                  B    |
|                -----  |
|                     S |
|P                   B  |
|||||||||||||||||||||||||