Boing
||||||||||||||||||||
|           BB|  BB|
|             |    |
|             |    |
|             |H   |
|             |    |
|  ^^^^^^^^^^^|H   |
|             |    |
|             |H   |
|             |    |
|             |H   |
|             |    |
|^^^^^^^^^^^  |H   |
|                  |
|P                 |
|||||||||||||||MMMM|